12
3

10001,10001,10001,10001,10001,10001,10001,10001,10001,10001,10001,
10001,10001,10001,10001,10001,10001,10001,10001,10001,10001,10001,
10001,10001,10001,10001,10001,10001,10001,10001,10001,10001,10001,
10001,10001,10001,10001,10001,10001,10001,10001,10001,10001,10001,
10001,10001,10001,10901,10901,10901,10901,10901,10001,10001,10001,
10001,10001,10001,10901,10901,15101,10901,10901,10001,10001,10001,
10001,10001,10001,10001,10001,10001,10001,10001,10001,10001,10001,
10001,10001,10001,10001,10001,10001,10001,10001,10001,10001,10001,
10001,10001,10001,10001,10001,10001,10001,10001,10001,10001,10001,
10001,10001,10001,10001,10001,10001,10001,10001,10001,10001,10001,
10001,10001,10001,10001,10001,10001,10001,10001,10001,10001,10001,

10001,10001,10001,10001,10001,10001,10001,10001,10001,10001,10001,
10001,10001,10001,10001,10001,10001,10001,10001,10001,10001,10001,
10001,10001,10001,10001,10001,10001,10001,10001,10001,10001,10001,
10001,10001,10001,10001,10001,10001,10001,10001,10001,10001,10001,
10001,10001,10001,11001,11001,15101,11001,12101,10001,10001,10001,
10001,10001,10001,10101,10001,10001,10001,12401,10001,10001,10001,
10001,10001,10001,10001,10001,10001,10001,10001,10001,10001,10001,
10001,10001,10001,10001,10001,10001,10001,10001,10001,10001,10001,
10001,10001,10001,10001,10001,10001,10001,10001,10001,10001,10001,
10001,10001,10001,10001,10001,10001,10001,10001,10001,10001,10001,
10001,10001,10001,10001,10001,10001,10001,10001,10001,10001,10001,

10001,10001,10001,10001,10001,10001,10001,10001,10001,10001,10001,
10001,10001,10001,10001,10001,10001,10001,10001,10001,10001,10001,
10001,10001,10001,10001,10001,10001,10001,10001,10001,10001,10001,
10001,10001,10001,10001,10001,10001,10001,10001,10001,10001,10001,
10001,10001,10001,10201,10001,10001,10001,10001,10001,10001,10001,
10001,10001,10001,10001,10001,10001,10001,10001,10001,10001,10001,
10001,10001,10001,10001,10001,10001,10001,10001,10001,10001,10001,
10001,10001,10001,10001,10001,10001,10001,10001,10001,10001,10001,
10001,10001,10001,10001,10001,10001,10001,10001,10001,10001,10001,
10001,10001,10001,10001,10001,10001,10001,10001,10001,10001,10001,
10001,10001,10001,10001,10001,10001,10001,10001,10001,10001,10001,

10001,10001,10001,10001,10001,10001,10001,10001,10001,10001,10001,
10001,10001,10001,10001,10001,10001,10001,10001,10001,10001,10001,
10001,10001,10001,10001,10001,10001,10001,10001,10001,10001,10001,
10001,10001,10001,10001,10001,10001,10001,10001,10001,10001,10001,
10001,10001,10001,10001,10001,10001,10001,10001,10001,10001,10001,
10001,10001,10001,10001,10001,10001,10001,10001,10001,10001,10001,
10001,10001,10001,10001,10001,10001,10001,10001,10001,10001,10001,
10001,10001,10001,10001,10001,10001,10001,10001,10001,10001,10001,
10001,10001,10001,10001,10001,10001,10001,10001,10001,10001,10001,
10001,10001,10001,10001,10001,10001,10001,10001,10001,10001,10001,
10001,10001,10001,10001,10001,10001,10001,10001,10001,10001,10001,

10001,10001,10001,10001,10001,10001,10001,10001,10001,10001,10001,
10001,10001,10001,10001,10001,10001,10001,10001,10001,10001,10001,
10001,10001,10001,10001,10001,10001,10001,10001,10001,10001,10001,
10001,10001,10001,10001,10001,10001,10001,10001,10001,10001,10001,
10001,10001,10001,10001,10001,10001,10001,10001,10001,10001,10001,
10001,10001,10001,10001,10001,10001,10001,10001,10001,10001,10001,
10001,10001,10001,10001,10001,10001,10001,10001,10001,10001,10001,
10001,10001,10001,10001,10001,10001,10001,10001,10001,10001,10001,
10001,10001,10001,10001,10001,10001,10001,10001,10001,10001,10001,
10001,10001,10001,10001,10001,10001,10001,10001,10001,10001,10001,
10001,10001,10001,10001,10001,10001,10001,10001,10001,10001,10001,