23
5

10001,10001,10001,10001,10001,10001,10001,10001,10001,10001,10001,
10001,10001,10001,10001,10001,10001,10001,10001,10001,10001,10001,
10001,10001,10001,10001,10001,11301,11301,11301,10001,10001,10001,
10001,10001,10001,10001,10001,10001,10001,10001,10001,10001,10001,
10001,10001,11301,11301,11301,11301,10001,10001,10001,10001,10001,
10001,10001,11301,11301,11301,11301,11301,10001,10001,10001,10001,
10001,10001,11301,11301,11301,11301,11301,10001,10001,10001,10001,
10001,10001,10001,10001,10001,10001,10001,10001,10001,10001,10001,
10001,10001,10001,10001,10001,10001,10001,10001,10001,10001,10001,
10001,10001,10001,10001,10001,10001,10001,10001,10001,10001,10001,
10001,10001,10001,10001,10001,10001,10001,10001,10001,10001,10001,

10001,10001,10001,10001,10001,10001,10001,10001,10001,10001,10001,
10001,10001,10001,10001,10001,10001,10001,10001,10001,10001,10001,
10001,10001,10001,10001,10001,13121,11401,11401,10001,10001,10001,
10001,10001,10001,10001,10001,10001,10001,10001,10001,10001,10001,
10001,10001,11401,11401,11401,11401,10001,10001,10001,10001,10001,
10001,10001,11401,11401,11401,11401,10001,10001,10001,10001,10001,
10001,10001,11401,11401,11401,11401,13401,10001,10001,10001,10001,
10001,10001,10001,10001,10001,10001,10001,10001,10001,10001,10001,
10001,10001,10001,10001,10001,10001,10001,10001,10001,10001,10001,
10001,10001,10001,10001,10001,10001,10001,10001,10001,10001,10001,
10001,10001,10001,10001,10001,10001,10001,10001,10001,10001,10001,

10001,10001,10001,10001,10001,10001,10001,10001,10001,10001,10001,
10001,10001,10001,10001,10001,10001,10001,10001,10001,10001,10001,
10001,10001,10001,10001,10001,10001,11401,11401,10001,10001,10001,
10001,10001,10001,10001,10001,10001,10001,10001,10001,10001,10001,
10001,10001,11401,11401,11401,11401,10001,10001,10001,10001,10001,
10001,10001,11401,11401,11401,11401,10001,10001,10001,10001,10001,
10001,10001,11401,11401,11401,11401,10001,10001,10001,10001,10001,
10001,10001,10001,10001,10001,10001,10001,10001,10001,10001,10001,
10001,10001,10001,10001,10001,10001,10001,10001,10001,10001,10001,
10001,10001,10001,10001,10001,10001,10001,10001,10001,10001,10001,
10001,10001,10001,10001,10001,10001,10001,10001,10001,10001,10001,

10001,10001,10001,10001,10001,10001,10001,10001,10001,10001,10001,
10001,10001,10001,10001,10001,10001,10001,10001,10001,10001,10001,
10001,10001,10001,10001,10001,10001,10001,10201,10001,10001,10001,
10001,10001,10001,10001,10001,10001,10001,10001,10001,10001,10001,
10001,10001,13401,10801,10001,10801,10001,10001,10001,10001,10001,
10001,10001,10001,10001,13401,10801,10001,10001,10001,10001,10001,
10001,10001,10001,10001,10101,13401,10001,10001,10001,10001,10001,
10001,10001,10001,10001,10001,10001,10001,10001,10001,10001,10001,
10001,10001,10001,10001,10001,10001,10001,10001,10001,10001,10001,
10001,10001,10001,10001,10001,10001,10001,10001,10001,10001,10001,
10001,10001,10001,10001,10001,10001,10001,10001,10001,10001,10001,

10001,10001,10001,10001,10001,10001,10001,10001,10001,10001,10001,
10001,10001,10001,10001,10001,10001,10001,10001,10001,10001,10001,
10001,10001,10001,10001,10001,10001,10001,10001,10001,10001,10001,
10001,10001,10001,10001,10001,10001,10001,10001,10001,10001,10001,
10001,10001,10001,10001,10001,10001,10001,10001,10001,10001,10001,
10001,10001,10001,10001,10001,10001,10001,10001,10001,10001,10001,
10001,10001,10001,10001,10001,10001,10001,10001,10001,10001,10001,
10001,10001,10001,10001,10001,10001,10001,10001,10001,10001,10001,
10001,10001,10001,10001,10001,10001,10001,10001,10001,10001,10001,
10001,10001,10001,10001,10001,10001,10001,10001,10001,10001,10001,
10001,10001,10001,10001,10001,10001,10001,10001,10001,10001,10001,