5
 101  101  101  101  101  101  101  101  101  101  101
 101  401  401  401  401  401  401  401  401  401  101
 101  401  401  401  401  401  401  401  401  401  101
 101  401  401  401  401  401  401  401  401  401  101
 101  401  401  401  401  401  401  401  401  401  101
 101  401  401  401  401  401  401  401  401  401  101
 101  401  401  401  401  401  401  401  401  401  101
 101  401  401  401  401  401  401  401  401  401  101
 101  401  401  401  401  401  401  401  401  401  101
 101  401  401  401  401  401  401  401  401  401  101
 101  101  101  101  101  101  101  101  101  101  101

 101  101  101  101  101  101  101  101  101  101  101
 101  201  101  101  101  101  101  101  101  101  101
 101  101  101  101  101  101  101  101  101  101  101
 101  101  101  101  101  101  101  101  101  101  101
 101  101  101  101  101  101  101  101  101  101  101
 101  101  101  101  101  101  101  101  101  101  101
 101  101  101  101  101  101  101  101  101  101  101
 101  101  101  101  101  101  101  101  101  101  101
 101  101  101  101  101  101  101  101  101  101  101
 101  101  101  101  101  101  101  101  101  101  101
 101  101  101  101  101  101  101  101  101  101  101

 101  101  101  101  101  101  101  101  101  101  101
 101  101  101  101  101  101  101  101  101  101  101
 101  101  101  101  101  101  101  101  101  101  101
 101  101  101  101  101  101  101  101  101  101  101
 101  101  101  101  101  101  101  101  101  101  101
 101  101  101  101  101  101  101  101  101  101  101
 101  101  101  101  101  101  101  101  101  101  101
 101  101  101  101  101  101  101  101  101  101  101
 101  101  101  101  101  101  101  101  101  101  101
 101  101  101  101  101  101  101  101  101  101  101
 101  101  101  101  101  101  101  101  101  101  101

 101  101  101  101  101  101  101  101  101  101  101
 101  101  101  101  101  101  101  101  101  101  101
 101  101  101  101  101  101  101  101  101  101  101
 101  101  101  101  101  101  101  101  101  101  101
 101  101  101  101  101  101  101  101  101  101  101
 101  101  101  101  101  101  101  101  101  101  101
 101  101  101  101  101  101  101  101  101  101  101
 101  101  101  101  101  101  101  101  101  101  101
 101  101  101  101  101  101  101  101  101  101  101
 101  101  101  101  101  101  101  101  101  101  101
 101  101  101  101  101  101  101  101  101  101  101

 101  101  101  101  101  101  101  101  101  101  101
 101  101  101  101  101  101  101  101  101  101  101
 101  101  101  101  101  101  101  101  101  101  101
 101  101  101  101  101  101  101  101  101  101  101
 101  101  101  101  101  101  101  101  101  101  101
 101  101  101  101  101  101  101  101  101  101  101
 101  101  101  101  101  101  101  101  101  101  101
 101  101  101  101  101  101  101  101  101  101  101
 101  101  101  101  101  101  101  101  101  101  101
 101  101  101  101  101  101  101  101  101  101  101
 101  101  101  101  101  101  101  101  101  101  101